1 2 3 88 89 90 4 5 6 91 92 93 1 2 3 88 89 90 273 274 
30 31 32 117 118 119 33 34 35 120 121 122 30 31 32 117 118 119 302 303 
59 60 61 146 147 148 62 63 64 149 150 151 59 60 61 146 147 148 0 0 
88 89 89 89 89 89 89 89 90 91 92 92 92 92 92 92 92 93 273 274 
117 118 118 118 118 118 118 118 119 120 121 121 121 121 121 121 121 122 302 303 
146 147 147 147 147 147 147 147 148 149 150 150 150 150 150 150 150 151 0 0 
1 2 2 2 3 4 5 5 5 6 1 2 2 2 3 88 89 89 89 90 
30 31 31 31 32 33 34 34 34 35 30 31 31 31 32 117 118 118 118 119 
59 60 60 60 61 62 63 63 63 64 59 60 60 60 61 146 147 147 147 148 
88 89 89 89 89 89 89 89 89 90 91 92 92 92 92 92 92 92 92 93 
117 118 118 118 118 118 118 118 118 119 120 121 121 121 121 121 121 121 121 122 
117 118 118 118 118 118 118 118 118 119 120 121 121 121 121 121 121 121 121 122 
117 118 118 118 118 118 118 118 118 119 120 121 121 121 121 121 121 121 121 122 
146 147 147 147 147 147 147 147 147 148 149 150 150 150 150 150 150 150 150 151 
1 2 3 4 5 6 91 92 93 88 89 90 1 2 3 1 2 3 215 216 
30 31 32 33 34 35 120 121 122 117 118 119 30 31 32 30 31 32 244 245 
59 60 61 62 63 64 149 150 151 146 147 148 59 60 61 59 60 61 215 216 
91 92 93 1 2 3 4 5 6 1 2 3 88 89 90 91 92 93 244 245 
120 121 122 30 31 32 33 34 35 30 31 32 117 118 119 120 121 122 215 216 
149 150 151 59 60 61 62 63 64 59 60 61 146 147 148 149 150 151 244 245
